ḥalāl economy                                       	halal economy                                       	                                                    	                                                    	
maṣlaḥa                                             	maslaha                                             	                                                    	                                                    	
call for papers                                     	Call for papers                                     	Call for Papers                                     	                                                    	
triple ṭalāq                                        	triple talaq                                        	                                                    	                                                    	
podcasts                                            	podcasts                                            	Podcasts                                            	podcasts                                            	
shurūḥ                                              	shuruh                                              	shurūḥ                                              	shurūḥ                                              	
Ḥaram                                               	haram                                               	                                                    	                                                    	
opportunities                                       	opportunities                                       	Opportunities                                       	opportunities                                       	
academic freedom                                    	academic freedom                                    	Academic freedom                                    	academic freedom                                    	
research                                            	research                                            	Research                                            	research                                            	
U.S. Supreme Court                                  	u.s. supreme court                                  	U.S. Supreme Court                                  	U.S. Supreme court                                  	
ḥijāb                                               	hijab                                               	                                                    	                                                    	
Digital Islamic Law Lab                             	digital islamic law lab                             	digital islamic law lab                             	Digital Islamic Law Lab                             	
legal history                                       	legal history                                       	legal history                                       	Legal history                                       	
al-Shāfi‘ī                                          	al-shafii                                           	al-Shāfi‘ī                                          	Al-Shāfiʿī                                          	
ḥadīth                                              	hadith                                              	ḥadīṯh                                              	ḥadīth                                              	hadith
sharīʿa                                             	sharia                                              	Sharīʿa                                             	shari’a                                             	sharīʿa
nikāḥ                                               	nikah                                               	nikāḥ                                               	nikāh                                               	nikah
resource roundup                                    	resource roundup                                    	resource roundup                                    	Resource Roundup                                    	
media                                               	media                                               	Media                                               	media                                               	
women's rights                                      	"b""women's rights"""                               	women's rights                                      	Women's Rights                                      	
ḥalāl meat                                          	halal meat                                          	                                                    	                                                    	
Muhammad                                            	Muḥammad                                            	Prophet Muḥammad                                    	Prophet Muhammad                                    	
international law                                   	international law                                   	International Law                                   	international law                                   	
murābaḥa                                            	murabaha                                            	                                                    	                                                    	
civil rights                                        	Civil rights                                        	Civil Rights                                        	                                                    	
events                                              	events                                              	events                                              	Events                                              	
Ibn al-Qaṭṭān al-Fāsī’                              	ibn al-qattan al-fasi                               	Ibn al-Qaṭṭān al-Fāsī’                              	Ibn al-Qaṭṭān al-Fāsī’                              	
contract law                                        	contract law                                        	contract law                                        	Contract law                                        	
ḥudūd                                               	hudud                                               	hudūd                                               	ḥudūd                                               	
marriage                                            	marriage                                            	marriage                                            	Marriage                                            	
maqāṣid                                             	maqasid                                             	Maqāsid                                             	maqāṣid                                             	
ʿAbd al-Ḥamīd                                       	abd al-hamid                                        	ʿAbd al-Ḥamīd                                       	ʿAbd al-Ḥamīd                                       	
ʿAlī al-Sīstānī                                     	Ali al-Sistani                                      	                                                    	                                                    	
constitutional law                                  	constitutional law                                  	constitutional law                                  	Constitutional law                                  	
comparative law                                     	comparative law                                     	comparative law                                     	Comparative law                                     	
expert commentary                                   	expert commentary                                   	expert commentary                                   	Expert Commentary                                   	
Āshūrāʾ                                             	ashura                                              	Âshūrā                                              	Āshūrāʾ                                             	
Fatāwā wa-masāʾil Ibn al-Ṣalāḥ                      	fatawa wa-masail ibn al-salah                       	Fatāwā wa-masāʾil Ibn al-Ṣalāḥ                      	Fatāwā wa-masāʾil Ibn al-Ṣalāḥ                      	
ṣukūk                                               	sukuk                                               	                                                    	                                                    	
Morocco                                             	morocco                                             	morocco                                             	Morocco                                             	
naẓar                                               	nazar                                               	naẓar                                               	naẓar                                               	
laïcité                                             	laicite                                             	                                                    	                                                    	
Mālikī                                              	maliki                                              	Mālikī                                              	Malikī                                              	
Nigeria                                             	nigeria                                             	nigeria                                             	Nigeria                                             	
Islam and data science roundup                      	islam and data science roundup                      	Islam and Data Science Roundup                      	Islam and data science roundup                      	
Ḥanbalī judges                                      	hanbali judges                                      	Ḥanbalī judges                                      	Ḥanbalī judges                                      	
privacy                                             	privacy                                             	Privacy                                             	privacy                                             	
clerics                                             	clerics                                             	Clerics                                             	clerics                                             	
divorce                                             	divorce                                             	divorce                                             	Divorce                                             	
Islamic finance                                     	islamic finance                                     	Islamic Finance                                     	Islamic finance                                     	
waqf                                                	waqf                                                	waqf                                                	Waqf                                                	
Abū Ḥanīfa                                          	Abu Hanifa                                          	                                                    	                                                    	
Twelver Uṣūl Bibliography                           	Twelver Usul Bibliography                           	                                                    	                                                    	
pluralism                                           	pluralism                                           	Pluralism                                           	pluralism                                           	
Abū Shujāʿ                                          	abu shuja                                           	Abū Shujāʿ                                          	Abū Shujāʿ                                          	
Islamic law in US courts                            	islamic law in us courts                            	Islamic law in US courts                            	Islamic Law in US Courts                            	
bunyān                                              	bunyan                                              	bunyān                                              	bunyān                                              	
property law                                        	property law                                        	property law                                        	Property law                                        	
Ḥanafī law                                          	Hanafi Law                                          	                                                    	                                                    	
Ghazālı̄                                             	ghazal                                              	Ghazālı̄                                             	Ghazālı̄                                             	
employment law                                      	employment law                                      	employment law                                      	Employment law                                      	
Muslim jurists                                      	muslim jurists                                      	Muslim Jurists                                      	Muslim jurists                                      	
intellectual property                               	intellectual property                               	Intellectual Property                               	intellectual property                               	
Ḥujja                                               	Hujja                                               	                                                    	                                                    	
Dār al-Iftāʾ                                        	dar al-ifta                                         	                                                    	                                                    	
al-Muwaṭṭaʾ                                         	Al-Muwatta                                          	                                                    	                                                    	
recent developments                                 	recent developments                                 	recent developments                                 	Recent developments                                 	
ḥajj                                                	Hajj                                                	                                                    	                                                    	
Supreme Court of Pakistan’                          	Supreme Court of Pakistan                           	                                                    	                                                    	
Birūnī                                              	biruni                                              	Birūnī                                              	Birūnī                                              	
criminal law                                        	criminal law                                        	criminal law                                        	Criminal law                                        	
ḥalāl                                               	halal                                               	                                                    	                                                    	
digital humanities                                  	digital humanities                                  	digital humanities                                  	Digital Humanities                                  	
Mālikī Law                                          	maliki law                                          	Malikī law                                          	Mālikī Law                                          	
interview                                           	interview                                           	Interview                                           	interview                                           	
sharḥ                                               	sharh                                               	sharḥ                                               	sharḥ                                               	
ʿulamāʾ                                             	ulama                                               	ʿulamāʾ                                             	ulamāʾ                                              	
ṭalāq                                               	talaq                                               	                                                    	                                                    	
Shīʿī                                               	shii                                                	Shīʽī                                               	Shīʿī                                               	
ḥijāb ban                                           	hijab ban                                           	hijāb ban                                           	ḥijāb ban                                           	
family law                                          	family law                                          	Family law                                          	family law                                          	
violence                                            	violence                                            	violence                                            	Violence                                            	
zakāt                                               	zakat                                               	                                                    	                                                    	
Dīwān al-aḥkām                                      	diwan al-ahkam                                      	Dīwān al-aḥkām                                      	Dīwān al-aḥkām                                      	
ḥadīth dating                                       	hadith dating                                       	ḥadīṯh dating                                       	ḥadīth dating                                       	
Ḥanafī                                              	Hanafi                                              	                                                    	                                                    	
Averroës                                            	averroes                                            	Averroës                                            	Averroës                                            	
Iḥkām an-naẓar fī aḥkām an-naẓar bi-hāssat al-baṣar 	ihkam an-nazar fi ahkam an-nazar bi-hassat al-basar 	Iḥkām an-naẓar fī aḥkām an-naẓar bi-hāssat al-baṣar 	Iḥkām an-naẓar fī aḥkām an-naẓar bi-hāssat al-baṣar 	
Digital Islamic law                                 	digital islamic law                                 	Digital Islamic Law                                 	Digital Islamic law                                 	
data                                                	data                                                	data                                                	Data                                                	
jurisdiction                                        	jurisdiction                                        	jurisdiction                                        	Jurisdiction                                        	
Kitab al-I’lan Bi-Aḥkām al-Bunyān                   	kitab al-ilan bi-ahkam al-bunyan                    	Kitab al-I’lan Bi-Aḥkām al-Bunyān                   	Kitab al-I’lan Bi-Aḥkām al-Bunyān                   	
Ibn al-Ṣalāḥ                                        	ibn al-salah                                        	Ibn al-Ṣalāḥ                                        	Ibn al-Ṣalāḥ                                        	
in the news                                         	in the news                                         	In The News                                         	in the news                                         	
rule of law                                         	rule of law                                         	Rule of law                                         	rule of law                                         	
Digital Islamic Law Collection                      	digital islamic law collection                      	digital islamic law collection                      	Digital Islamic Law Collection                      	
courts                                              	courts                                              	Courts                                              	courts                                              	
qāḍī                                                	qadi                                                	                                                    	                                                    	
al-Zamalkānī                                        	al-zamalkani                                        	al-Zamalkānī                                        	al-Zamalkānī                                        	
Walī Allāh                                          	wali allah                                          	Walī Allāh                                          	Walī Allāh                                          	
al-Jāḥiẓ                                            	al-jahiz                                            	al-Jāḥiẓ                                            	al-Jāḥiẓ                                            	
Ibn al-Rāmi                                         	ibn al-rami                                         	Ibn al-Rāmi                                         	Ibn al-Rāmi                                         	
